// Use http://centricle.com/tools/ascii-hex/ for hex codes
urlHelp=Scripts/mxGraph/src/editor/help/index.html
lastSaved=最近保存
currentFile=当前文件
toolbar=Tools
save=保存
print=打印
cut=剪切
copy=复制
paste=粘贴
delete=删除
undo=撤销
redo=重复
select=选择
connect=连线
message=消息
pan=Pan
zoomIn=Zoom In
zoomOut=Zoom Out
zoom=缩放
fit=合适
actualSize=实际尺寸
selectAll=全选
clearSelection=清除选择
shape=形状
format=格式
font=字体
group=组合
ungroup=解除组合
removeFromParent=脱离
properties=属性
align=对齐
left=左
right=右
center=中心
top=顶部
middle=中间
bottom=底部
collapse=折叠
expand=展开
toBack=最底部
toFront=最前端
enterGroup=进入组合
exitGroup=退出组合
layout=布局
format=格式
horizontalTree=水平树形
verticalTree=垂直树形
fillColor=填充颜色
strokeColor=笔画颜色
gradientColor=渐进颜色
bold=粗体
italic=斜体
fontColor=字体颜色
fontSize=字体大小
fontFamily=字体库
processList=流程列表
newDiagram=新建...
openDiagram=打开...
saveDiagram=保存
previewXml=查看XML...
importDiagram=导入XML...
image=图片
opacity=透明度
selection=选择
Layout=布局
Format=格式
Rounded=圆角
editStyle=编辑样式
enterStyle=输入样式
enterColorname=输入颜色名称
enterImageUrl=输入图片URL
enterOpacity=输入透明度(%)
enterFontsize=输入字体大小(pt)
enterFontfamily=输入字体库
toggleRounded=圆角
toggleShadow=阴影
openHref=打开URL
show=显示
exportImage=导出图片
exportSvg=导出SVG
changesLost=所有改变将会丢失!
swimlanes=泳道
travelBooking=Travel Booking
notAvailable=不可用

